111111111111111111111111111111111
100000000000000000000000000000001
10001111000111100011110001111P001
10000001000C001000000100000010001
10000E010000001000000100000010001
100000010001111000111100000010001
100000010000001000000100000010001
100000010000001000000100000010001
100000010001111000111100000010001
100000000000000000000000000000001
111111111111111111111111111111111