1111111111111111111111
1001000000000000000P01
1EC0000000001000000001
1010000000010100000001
1111111111111111111111