1111111111111111111111
1E1P000C00001111110C01
1000000011100000000001
1000000011111110000001
1000000011100000011101
1000000C111000000000C1
1111111111111111111111