11111111111111111111111
1010000C00001111110C011
10000000111000000PE0011
10000000101111100000011
100000000C1000000111011
1000000C101000000000C11
11111111111111111111111